21111111111111111111111111111111111111111111111112
10000000000000000000000000000000000000000000000001
10000000000000000000000000000000000000000000000001
10000000000000000000000000000000000000000000000001
10000000000000000000000000000000000000000000000001
10000000111111111000000000000000000000000100000001
10000000000000001000000000000000000000000100000001
10000000000000001000000000000000000000000100000001
10000000000000001000000000000000000000000100000001
10000000000000001000000000000000000000000100000001
10000000000000000000000000000000011111111100000001
10000000000000000000000000000000000000000000000001
10000000111111111000000000000000000000000000000001
10000000100000000000000000000010000000000000000001
10000000100000000000000000000010000000000000000001
10000000100000000000000000000010000000000000000001
10000000100000000000000000000010000000000000000001
10000000100000000000000000000011111111111100000001
10000000000000000000000000000000000000000000000001
10000000000000000000000000000000000000000000000001
10000000000000000000000000000000000000000000000001
10000000000000000000000000000000000000000000000001
21111111111111111111111111111111111111111111111112